XXXXXXXXXXX
X    M   PX
X OO      X
X OOO     X
XP   B PS X
XXXXXXXXXXX
